AA		ɒ
AE		æ
AH		ʌ
AO		ɔ
AW		aʊ
AY		ai
B		b
CH		tʃ
D		d
DH		ð
EH		ɛ
ER		ə
EY		ei
F		f
G		g
HH		h
IH		i
IY		I
JH		dʒ
K		k
L		l
M		m
N		n
NG		ŋ	
OW		oʊ
OY		ɔi
P		p
R		ɹ
S		s
SH		ʃ		
T		t
TH		θ
UH		ʊ
UW		U
V		v
W		w
Y		j
Z		z
ZH		ʒ